REB = "setup/countries/rebels.txt"
PIR = "setup/countries/pirates.txt"
BAR = "setup/countries/barbarians.txt"
MER = "setup/countries/mercenaries.txt"

###SPECIAL###
TEU = "setup/countries/teu.txt"

###COUNTRY FORMATIONS###
SPA = "setup/countries/spa.txt"
GBR = "setup/countries/gbr.txt"
RME = "setup/countries/rme.txt"
WLH = "setup/countries/wlh.txt"

###WESTERN EUROPE###

# France&GreatBritain
ENG = "setup/countries/eng.txt"
FRA = "setup/countries/fra.txt"
TOL = "setup/countries/tol.txt"
POV = "setup/countries/pov.txt"
BRG = "setup/countries/brg.txt"
BEN = "setup/countries/ben.txt"
AQT = "setup/countries/aqt.txt"
FOL = "setup/countries/fol.txt"
ZAH = "setup/countries/zah.txt" 
BUG = "setup/countries/bug.txt"
SAV = "setup/countries/sav.txt"
DAU = "setup/countries/dau.txt"

# Celts
IR1 = "setup/countries/ir1.txt"
IR2 = "setup/countries/ir2.txt"
IR3 = "setup/countries/ir3.txt"
IR4 = "setup/countries/ir4.txt"
IR5 = "setup/countries/ir5.txt"
IR6 = "setup/countries/ir6.txt"
IR7 = "setup/countries/ir7.txt"
SCO = "setup/countries/sco.txt"
BRI = "setup/countries/bri.txt"
GWY = "setup/countries/gwy.txt"
DHB = "setup/countries/dhb.txt"
POW = "setup/countries/pow.txt"

# Holy Roman Empire
RUG = "setup/countries/rug.txt"
POM = "setup/countries/pom.txt"
PMR = "setup/countries/pmr.txt"
SIL = "setup/countries/sil.txt"
BOH = "setup/countries/boh.txt"
LUB = "setup/countries/lub.txt"
KRA = "setup/countries/kra.txt"
CAR = "setup/countries/car.txt"
TIR = "setup/countries/tir.txt"
AUS = "setup/countries/aus.txt"
SLZ = "setup/countries/slz.txt"
HLS = "setup/countries/hls.txt"
HAM = "setup/countries/ham.txt"
MKL = "setup/countries/mkl.txt"
BRA = "setup/countries/bra.txt"
MAG = "setup/countries/mag.txt"
ANH = "setup/countries/anh.txt"
SAX = "setup/countries/sax.txt"
SW1 = "setup/countries/sw1.txt"
SW2 = "setup/countries/sw2.txt"
SW3 = "setup/countries/sw3.txt"
BAV = "setup/countries/bav.txt"
BA2 = "setup/countries/ba2.txt"
BA3 = "setup/countries/ba3.txt"
BA4 = "setup/countries/ba4.txt"
NUR = "setup/countries/nur.txt"
BAM = "setup/countries/bam.txt"
WUZ = "setup/countries/wuz.txt"
ANS = "setup/countries/ans.txt"
WUT = "setup/countries/wut.txt"
ULM = "setup/countries/ulm.txt"
RAV = "setup/countries/rav.txt"
FRI = "setup/countries/fri.txt"
FLA = "setup/countries/fla.txt"
HOL = "setup/countries/hol.txt"
PFA = "setup/countries/pfa.txt"
MAI = "setup/countries/mai.txt"
BAD = "setup/countries/bad.txt"
ALS = "setup/countries/als.txt"
BRN = "setup/countries/brn.txt"
BRE = "setup/countries/bre.txt"
COL = "setup/countries/col.txt"
MTZ = "setup/countries/mtz.txt"
UTR = "setup/countries/utr.txt"
GEL = "setup/countries/gel.txt"
OLD = "setup/countries/old.txt"
MUN = "setup/countries/mun.txt"
BRB = "setup/countries/brb.txt"
LUX = "setup/countries/lux.txt"
LIE = "setup/countries/lie.txt"
TRE = "setup/countries/tre.txt"
FRK = "setup/countries/frk.txt"
HES = "setup/countries/hes.txt"
LUN = "setup/countries/lun.txt"
CLE = "setup/countries/cle.txt"
LOR = "setup/countries/lor.txt"
HAI = "setup/countries/hai.txt"
RET = "setup/countries/ret.txt"

# Iberian Peninsula
CAS = "setup/countries/cas.txt"
NAV = "setup/countries/nav.txt"
POR = "setup/countries/por.txt"
ARA = "setup/countries/ara.txt"
LEO = "setup/countries/leo.txt"

# Italy,Corsica&Sardinia
GEN = "setup/countries/gen.txt"
PIS = "setup/countries/pis.txt"
PAP = "setup/countries/pap.txt"
SIC = "setup/countries/sic.txt"
VEN = "setup/countries/ven.txt"
CO1 = "setup/countries/co1.txt"
CO2 = "setup/countries/co2.txt"
CO3 = "setup/countries/co3.txt"
CO4 = "setup/countries/co4.txt"
TRN = "setup/countries/trn.txt"
AQU = "setup/countries/aqu.txt"
VER = "setup/countries/ver.txt"
MAN = "setup/countries/man.txt"
SIE = "setup/countries/sie.txt"
FLO = "setup/countries/flo.txt"
LUC = "setup/countries/luc.txt"
PAR = "setup/countries/par.txt"
BRR = "setup/countries/brr.txt"
MLO = "setup/countries/mlo.txt"
MON = "setup/countries/mon.txt"
CUN = "setup/countries/cun.txt"
SPO = "setup/countries/spo.txt"

# Scandinavia
NOR = "setup/countries/nor.txt"
DAN = "setup/countries/dan.txt"
SWE = "setup/countries/swe.txt"


###EASTERN EUROPE###

# Greece/Balkans/Poland/Ukraine
BYZ = "setup/countries/byz.txt"
SER = "setup/countries/ser.txt"
BUL = "setup/countries/bul.txt"
HUN = "setup/countries/hun.txt"
LAT = "setup/countries/lat.txt"
TES = "setup/countries/tes.txt"
ACC = "setup/countries/acc.txt"
ATH = "setup/countries/ath.txt"
EPI = "setup/countries/epi.txt"

# Poland-Lithuania/Kievan-Rus/Ural Mountains
POL = "setup/countries/pol.txt"
GAV = "setup/countries/gav.txt"
KIE = "setup/countries/kie.txt"
CUM = "setup/countries/cum.txt"
MAZ = "setup/countries/maz.txt"

# Baltic coast
PPP = "setup/countries/ppp.txt"
NOV = "setup/countries/NOV.txt"
CUR = "setup/countries/CUR.txt"
OSE = "setup/countries/OSE.txt"
LIO = "setup/countries/LIO.txt"
SEM = "setup/countries/SEM.txt"
ROT = "setup/countries/ROT.txt"
VIR = "setup/countries/VIR.txt"
REV = "setup/countries/REV.txt"


###ASIA and AFRICA###

# Anatolia
CIL = "setup/countries/cil.txt"
RUM = "setup/countries/rum.txt"
TRB = "setup/countries/trb.txt"
NIC = "setup/countries/nic.txt"

# Irak, Iran, Armenia, Caucasus
GEO = "setup/countries/geo.txt"
ARM = "setup/countries/arm.txt"
AZZ = "setup/countries/azz.txt"
ABS = "setup/countries/abs.txt"
FAR = "setup/countries/far.txt"
KHO = "setup/countries/kho.txt"
ALN = "setup/countries/aln.txt"

# Crusader States
JER = "setup/countries/jer.txt"
ANT = "setup/countries/ant.txt"
TRI = "setup/countries/tri.txt"
CYP = "setup/countries/cyp.txt"

# North Africa, Egypt, Syria
ALA = "setup/countries/ala.txt"
AYY = "setup/countries/ayy.txt"
ALM = "setup/countries/alm.txt"
LYB = "setup/countries/lyb.txt"
